1111111111111
100100000S0C1
1000000000001
1P000100000E1
1111111111111
