1111111111111111
1C0100000S0C0001
10000000000S0001
1P0001000S0C00E1
1111111111111111
