1111111111
10000001P1
1C00100111
10000C00E1
1111101111
